10 19
###################
#+               +#
#  +     !     +  #
#  #           #  #
#+   +   +   +   +#
##   #   #   #  j##
#+     +-         #
    ####   ###### #
#/         #D     #
###################   