10 30
##############################
#+     +            +        D
#               %            @
#@  @       -@         #     #
#     j @@@   #       ##  ####
# @@     #    #  @@@@ #  ## +#
#    +   # @  #       # #    #
#   @@@ +#    # +++++ # # ## #
#/       #+  @#       #   #+ #
###ffffff#eeee#wwwwee#########
